,卒業年度（年）,島内自営・その他（人）,島内就職（人）,島外進学（人）,島外就職・その他（人）,合計（人）
0,21,2,1,7,3,13
1,22,0,0,12,2,14
2,23,0,1,12,3,16
3,24,0,0,17,2,19
4,25,0,0,6,2,8
5,26,0,0,2,7,9
6,27,1,0,1,4,6
7,28,0,0,5,6,11
8,29,0,0,11,3,14
9,30,0,0,9,3,12
10,1,0,1,3,1,5
