,卒業年度（年）,島内自営・その他（人）,島内就職（人）,島外進学（人）,島外就職・その他（人）,合計（人）
0,18,0,1,11,2,14
1,19,4,2,7,4,17
2,20,4,1,13,1,19
3,21,2,1,7,3,13
4,22,0,0,12,2,14
5,23,0,1,12,3,16
6,24,0,0,17,2,19
7,25,0,0,6,2,8
8,26,0,0,2,7,9
9,27,1,0,1,4,6
